NO ./path_to_the_north_texture
SO ./path_to_the_south_texture
WE ./path_to_the_west_texture
EA ./path_to_the_east_texture
F 220,100,0
C 225,30,0

111111111111111111111111111111111111111111111
100000000000000000000000000000000000000000001
101101101101101101101100000000000111111111101
100000000000000000000000000000000000000000101
100000000000000000000000000000000000000000101
100000000000000000000000000000000000000000101
100000000000000000000000000000010000000000101
1000000000000000000000000000001 1000000000101
100000000000000000000000000000010000000000001
100000000100000000000000000000000000000000001
1000000001000000000000000000000000000000000N1
100000000000000000000000000000000000000000001
100000000000000000000000000000000000000000001
100001010101010000000000000000000111110000001
100000000000000000000000000000000111110000001
100000000000000000000000000000000000000000001
100000000000000000000000000000000000000000001
100000000000000000000000000000000000000000001
100000000000000000000000000000000000000000001
111111111111111111111111111111111111111111111